WE ./images/halloween_item_02.png
NO ./images/magic_walls/magic_wall_n.png
SO  ./images/magic_walls/magic_wall_s.png
EA ./images/magic_walls/magic_wall_e.png

F  20,0,255
C            20,255,0

11111111
100100001
1000000001
1100W00001
1110000001
1111000001
   111111