NO ./images/magic_walls/magic_wall_e.png
SO ./images/magic_walls/magic_wall_s.png
WE ./images/magic_walls/magic_wall_w.png
EA ./images/magic_walls/magic_wall_e.png

F 42, 21, 7
C 0 , 0, 0


1111111111
10P0000DC1
101D110101
1010100101
1011110101
1000000101
10000001D1
101110D0W1
10000001D1
1000000001
1111111111
