NO ./images/magic_walls/magic_wall_e.png
SO ./images/magic_walls/magic_wall_s.png
WE ./images/magic_walls/magic_wall_w.png
EA ./images/magic_walls/magic_wall_e.png

F 42, 21, 7
C 0 , 0, 0


1111111111
1000000DC1
1011P101C1
1000010101
1D111101C1
1C1P010101
11100101C1
10D001D00W1
10111111C1
1000000DC1
1111111111
